대표키워드: 상황에 맞는 영단어

Abandon - 버리다, 포기하다
Abnormal - 비정상적인
Accumulate - 축적하다, 모으다
Admire - 감탄하다, 존경하다
Adventure - 모험
Adverse - 반대의, 불리한
Altruistic - 이타적인
Ample - 풍부한, 충분한
Analyze - 분석하다
Annoy - 짜증나게 하다
Anticipate - 예상하다, 예견하다
Appreciate - 감사하다, 감상하다
Arbitrary - 임의의, 제멋대로의
Assume - 가정하다, 추측하다
Authentic - 진짜의, 진본의
Avid - 열렬한, 열심인
Benevolent - 자비로운, 선의의
Brisk - 활발한, 빠른
Bizarre - 기이한, 이상한
Candid - 솔직한, 거리낌 없는
Capable - 능력 있는, 유능한
Comprehend - 이해하다
Contribute - 기여하다, 공헌하다
Crucial - 중요한, 결정적인
Dazzle - 눈부시게 하다
Deceive - 속이다
Defend - 방어하다, 지키다
Delicate - 섬세한, 연약한
Diligent - 근면한, 부지런한
Diminish - 감소하다, 줄어들다
Eccentric - 엉뚱한, 별난
Embrace - 포옹하다, 받아들이다
Enhance - 향상시키다, 강화하다
Essential - 필수적인
Exaggerate - 과장하다
Exhaust - 소모하다, 다 써버리다
Expand - 확장하다, 넓히다
Exclude - 제외하다
Exquisite - 정교한, 우아한
Falter - 흔들리다, 머뭇거리다
Fluctuate - 변동하다, 오르내리다
Fragile - 부서지기 쉬운, 약한
Frenzy - 광란, 열광
Genuine - 진짜의, 진실된
Grim - 엄격한, 불쾌한
Habitual - 습관적인
Hesitate - 망설이다
Hostile - 적대적인
Impose - 강요하다, 부과하다
Inquire - 묻다, 질문하다
Intense - 강렬한, 극심한
Irritate - 짜증나게 하다
Isolate - 고립시키다
Jovial - 유쾌한, 즐거운
Judicious - 현명한, 신중한
Keen - 예리한, 열망하는
Lament - 슬퍼하다, 애도하다
Luminous - 빛나는
Magnificent - 웅장한, 장엄한
Manipulate - 조작하다, 다루다
Melancholy - 우울한, 슬픈
Miserable - 불행한, 비참한
Mutual - 상호적인, 공동의
Neglect - 소홀히 하다, 무시하다
Obtain - 얻다, 획득하다
Obvious - 분명한, 명백한
Optimize - 최적화하다
Overcome - 극복하다
Perceive - 인식하다, 감지하다
Perplex - 당황하게 하다, 헷갈리게 하다
Persistent - 끈질긴, 지속적인
Pessimistic - 비관적인
Plentiful - 풍부한
Potential - 잠재적인, 가능성
Precise - 정확한, 정밀한
Pursue - 추구하다
Reconcile - 화해시키다, 조정하다
Reluctant - 마지못해 하는, 내키지 않는
Resilient - 회복력 있는
Skeptical - 의심 많은
Spontaneous - 자발적인, 자연스러운
Subtle - 미묘한, 감지하기 힘든
Tangible - 실질적인, 만질 수 있는
Tolerate - 용인하다, 참다
Trivial - 사소한, 하찮은
Ultimate - 궁극적인
Vague - 모호한, 애매한
Vast - 광대한, 거대한
Vivid - 선명한, 생생한
Vulnerable - 취약한, 연약한
Warrant - 보증하다, 정당화하다
Weary - 지친, 피곤한
Whimsical - 기발한, 변덕스러운
Widespread - 널리 퍼진, 광범위한
Withdraw - 철회하다, 물러나다
Zealous - 열심인, 열광적인
Zenith - 정점, 절정
Unanimous - 만장일치의
Unveil - 공개하다, 드러내다
Vocal - 목소리의, 적극적인